   NO ./textures/BRICK_3D.xpm
SO ./textures/BRICK_1A.xpm
              WE           ./textures/BRICK_6D.xpm
EA        ./textures/BRICK_3B.xpm      

           C 10,         10 , 10
F 64,64,66     

1111111111111111111111111
1000000000110000000000001
1011000001110000000000001
10010000000000000N000000111111111
111111111011000001110000000000001
10000000001100000111110011111111
11110111111111011100000000001
11110111111111011101010010001
11000000110101011100000010001    111
10000000000000001000000010001    101
10000000000000001101010010001    111
1100000111010101111101111000111
11110111 1110101 101111010001
11111111 1111111 111111111111
