NO ./textures/Brick1.xpm
SO ./textures/Brick2.xpm
WE ./textures/Brick3.xpm          
EA ./textures/Brick4.xpm 

F 20,20,20
C 200,200 ,2

1111111111111
1000000000001
1000000000001
1000000000001
1000000000001
10000000000N1
1000000000001
1000000000001
1000000000001
1000000000001
1111111111111
